7
7
XXXSXXX
XOOOOOO
XOXXXXO
XOXOOOX
XOOOXOX
XOXXXOX
XOXEOOX
